3,3,3,3,3,3,3,3,3,3,3,3,3,3,3,3,3,3,3,3,3,3,3,3,3,3,3,3,3,3,3,3,
3,3,3,3,3,3,3,3,3,3,3,3,3,3,3,3,3,3,3,3,3,3,3,3,3,3,3,3,3,3,3,3,
3,3,3,3,3,3,3,3,3,3,3,3,3,3,3,3,3,3,3,3,3,3,3,3,3,3,3,3,3,3,3,3,
3,3,3,3,3,3,3,3,3,3,3,3,3,3,3,3,3,3,3,3,3,3,3,3,3,3,3,3,3,3,3,3,
3,3,3,3,3,3,3,3,3,3,3,3,3,3,3,3,3,3,3,3,3,3,3,3,3,3,3,3,3,3,3,3,
3,3,3,3,3,3,3,6,7,7,7,7,7,7,7,7,7,7,7,7,7,24,7,8,3,3,3,3,3,3,3,3,
3,3,3,3,3,3,3,5,0,0,0,0,0,0,0,0,0,0,0,0,0,0,0,5,3,3,3,3,3,3,3,3,
3,3,3,3,3,3,3,5,0,0,0,0,0,0,0,0,0,0,0,0,0,0,0,5,3,3,3,3,3,3,3,3,
3,3,3,3,3,3,3,5,0,0,0,0,0,0,0,0,0,0,0,0,0,0,0,5,3,3,3,3,3,3,3,3,
3,3,3,3,3,3,3,5,0,0,0,0,0,0,0,0,0,0,0,0,0,0,0,5,3,3,3,3,3,3,3,3,
7,7,7,7,7,7,7,25,7,7,7,7,7,7,7,7,7,7,7,7,7,7,7,22,3,3,3,3,3,3,3,3,
3,3,3,3,3,3,3,5,0,0,0,0,0,0,0,0,0,0,0,0,0,0,0,5,3,3,3,3,3,3,3,3,
3,3,3,3,3,3,3,5,0,0,0,0,0,0,0,0,0,0,0,0,0,0,0,5,3,3,3,3,3,3,3,3,
3,3,3,3,3,3,3,5,0,0,0,0,0,0,0,0,0,0,0,0,0,0,0,5,3,3,3,3,3,3,3,3,
3,3,3,3,3,3,3,5,0,0,0,0,0,0,0,0,0,0,0,0,0,0,0,5,3,3,5,13,13,18,3,3,
3,3,3,3,3,3,3,21,7,24,7,7,7,24,8,0,0,0,0,0,0,0,0,21,7,7,22,2,2,14,3,3,
3,3,3,3,3,3,3,5,0,0,0,0,0,0,5,0,0,0,0,0,0,0,0,5,3,3,5,11,11,15,3,3,
3,3,3,3,3,3,3,5,0,0,0,0,0,0,5,0,0,0,0,0,0,0,0,5,3,3,3,3,3,3,3,3,
3,3,3,3,3,3,3,5,0,0,0,0,0,0,5,0,0,0,0,0,0,0,0,5,3,3,3,3,3,3,3,3,
3,3,3,3,3,3,3,21,7,7,7,7,7,7,9,0,0,0,0,0,0,0,0,5,3,3,3,3,3,3,3,3,
3,3,3,3,3,3,3,5,0,0,0,0,0,0,0,0,0,0,0,0,0,0,0,5,3,3,3,3,3,3,3,3,
3,3,3,3,3,3,3,5,0,0,0,0,0,0,0,0,0,0,0,0,0,0,0,5,3,3,3,3,3,3,3,3,
3,3,3,3,3,3,3,5,0,0,0,0,0,0,0,0,0,0,0,0,0,0,0,5,3,3,3,3,3,3,3,3,
3,3,3,3,3,3,3,5,0,0,0,0,0,0,0,0,0,0,0,0,0,0,0,5,3,3,3,3,3,3,3,3,
3,3,3,3,3,3,3,5,0,0,0,0,0,0,0,0,0,0,0,0,0,0,0,5,3,3,3,3,3,3,3,3,
3,3,3,3,3,3,3,5,0,0,0,0,0,0,0,0,0,0,0,0,0,0,0,5,3,3,3,3,3,3,3,3,
3,3,3,3,3,3,3,5,0,0,0,0,0,0,0,0,0,0,0,0,0,0,0,5,3,3,3,3,3,3,3,3,
3,3,3,3,3,3,3,5,0,0,0,0,0,0,0,0,0,0,0,0,0,0,0,5,3,3,3,3,3,3,3,3,
3,3,3,3,3,3,3,10,7,7,7,7,7,7,7,7,7,7,7,24,7,24,7,9,3,3,3,3,3,3,3,3,
3,3,3,3,3,3,3,3,3,3,3,3,3,3,3,3,3,3,3,3,3,3,3,3,3,3,3,3,3,3,3,3,
3,3,3,3,3,3,3,3,3,3,3,3,3,3,3,3,3,3,3,3,3,3,3,3,3,3,3,3,3,3,3,3,
3,3,3,3,3,3,3,3,3,3,3,3,3,3,3,3,3,3,3,3,3,3,3,3,3,3,3,3,3,3,3,3,